%%%%%%%%%%%%%%%%%%
%.               %
%       P        %
%                %
%                %
%                %
%                %
%                %
%                %
%                %
%                %
%                %
%                %
%      .         %
%                %
%                %
%%%%%%%%%%%%%%%%%%
